//MAP CONVERTED BY dmm2tgm.py THIS HEADER COMMENT PREVENTS RECONVERSION, DO NOT REMOVE
"au" = (
/obj/machinery/door/airlock/silver/glass,
/obj/effect/mapping_helpers/airlock/cutaiwire,
/obj/machinery/atmospherics/pipe/smart/manifold4w/supply/hidden{
	dir = 4
	},
/turf/open/floor/iron/dark,
/area/shuttle/chilldown)
"aA" = (
/obj/structure/rack{
	dir = 8;
	layer = 2.9
	},
/obj/item/toy/prize/ripley,
/obj/item/clothing/gloves/cargo_gauntlet,
/turf/open/floor/iron/kitchen_coldroom/freezerfloor,
/area/shuttle/chilldown)
"aZ" = (
/obj/machinery/suit_storage_unit/pirate,
/turf/open/floor/iron/kitchen_coldroom/freezerfloor,
/area/shuttle/chilldown)
"bk" = (
/obj/effect/decal/cleanable/blood/xtracks{
	dir = 4
	},
/obj/machinery/light/floor,
/turf/open/floor/circuit/off,
/area/shuttle/chilldown)
"cE" = (
/obj/structure/chair/sofa/corp/right{
	dir = 1
	},
/obj/machinery/light/directional/west,
/turf/open/floor/iron/kitchen_coldroom/freezerfloor,
/area/shuttle/chilldown)
"cH" = (
/obj/machinery/door/airlock/silver,
/obj/effect/mapping_helpers/airlock/cutaiwire,
/obj/machinery/atmospherics/pipe/smart/manifold4w/supply/hidden,
/turf/open/floor/pod/dark,
/area/shuttle/chilldown)
"de" = (
/obj/machinery/door/airlock/external/glass{
	id_tag = "pirateportexternal"
	},
/obj/machinery/atmospherics/pipe/smart/manifold4w/supply/hidden{
	dir = 4
	},
/turf/open/floor/pod/dark,
/area/shuttle/chilldown)
"dT" = (
/obj/structure/rack{
	dir = 8;
	layer = 2.9
	},
/obj/effect/spawner/lootdrop/alcohol_bottle,
/obj/item/clothing/glasses/cold,
/obj/item/clothing/glasses/cold,
/turf/open/floor/iron/kitchen_coldroom/freezerfloor,
/area/shuttle/chilldown)
"ei" = (
/obj/machinery/atmospherics/components/unary/vent_pump/on,
/turf/open/floor/iron/kitchen_coldroom/freezerfloor,
/area/shuttle/chilldown)
"es" = (
/obj/machinery/light/floor,
/turf/open/floor/circuit/off,
/area/shuttle/chilldown)
"eK" = (
/obj/structure/shuttle/engine/router,
/turf/open/floor/plating/airless,
/area/shuttle/chilldown)
"fH" = (
/obj/structure/fans/tiny,
/obj/effect/decal/cleanable/dirt/dust,
/obj/machinery/door/poddoor/shutters{
	id = "silverbridge_cargo"
	},
/turf/open/floor/engine,
/area/shuttle/chilldown)
"fN" = (
/obj/machinery/light/small/directional/north,
/turf/open/floor/circuit/off,
/area/shuttle/chilldown)
"fT" = (
/obj/machinery/atmospherics/pipe/smart/manifold4w/supply/hidden{
	dir = 4
	},
/obj/effect/decal/cleanable/dirt/dust,
/turf/open/floor/iron/kitchen_coldroom/freezerfloor,
/area/shuttle/chilldown)
"gg" = (
/obj/vehicle/sealed/mecha/working/ripley,
/turf/open/floor/iron/kitchen_coldroom/freezerfloor,
/area/shuttle/chilldown)
"he" = (
/obj/machinery/atmospherics/components/unary/vent_pump/on{
	dir = 4
	},
/obj/effect/decal/cleanable/dirt/dust,
/turf/open/floor/pod/dark,
/area/shuttle/chilldown)
"hr" = (
/obj/effect/decal/cleanable/robot_debris/down,
/turf/closed/wall/mineral/titanium,
/area/shuttle/chilldown)
"ht" = (
/obj/machinery/door/airlock/silver,
/obj/machinery/atmospherics/pipe/smart/manifold4w/supply/hidden,
/turf/open/floor/pod/dark,
/area/shuttle/chilldown)
"hO" = (
/obj/structure/bed/pod,
/obj/item/toy/plush/pkplush,
/obj/machinery/light/floor,
/turf/open/floor/iron/kitchen_coldroom/freezerfloor,
/area/shuttle/chilldown)
"hW" = (
/obj/machinery/atmospherics/pipe/smart/manifold4w/supply/hidden{
	dir = 8
	},
/obj/effect/decal/cleanable/dirt/dust,
/turf/open/floor/iron/kitchen_coldroom/freezerfloor,
/area/shuttle/chilldown)
"iv" = (
/obj/effect/decal/cleanable/oil/streak,
/obj/effect/decal/cleanable/dirt,
/turf/open/floor/engine,
/area/shuttle/chilldown)
"iy" = (
/obj/effect/decal/cleanable/blood/xtracks{
	dir = 4
	},
/obj/effect/decal/cleanable/dirt/dust,
/turf/open/floor/circuit/off,
/area/shuttle/chilldown)
"iY" = (
/obj/structure/mecha_wreckage/ripley/mk2,
/obj/effect/decal/cleanable/xenoblood,
/obj/effect/decal/cleanable/xenoblood/xgibs,
/obj/effect/decal/cleanable/xenoblood/xgibs/body,
/obj/effect/decal/cleanable/xenoblood/xgibs/up,
/turf/open/floor/iron/kitchen_coldroom/freezerfloor,
/area/shuttle/chilldown)
"je" = (
/turf/template_noop,
/area/template_noop)
"jj" = (
/obj/machinery/atmospherics/components/unary/vent_pump/on{
	dir = 1
	},
/turf/open/floor/iron/kitchen_coldroom/freezerfloor,
/area/shuttle/chilldown)
"jm" = (
/obj/machinery/door/airlock/external/glass{
	id_tag = "piratestarboardexternal"
	},
/obj/docking_port/mobile{
	dir = 4;
	dwidth = 13;
	height = 3;
	id = "chilldown";
	launch_status = 0;
	movement_force = list("KNOCKDOWN" = 0, "THROW" = 0);
	name = "The Chilldown";
	preferred_direction = 4;
	width = 26
	},
/turf/open/floor/pod/dark,
/area/shuttle/chilldown)
"jo" = (
/obj/effect/spawner/structure/window/shuttle,
/obj/machinery/atmospherics/pipe/smart/manifold4w/supply/hidden,
/turf/open/floor/plating,
/area/shuttle/chilldown)
"jv" = (
/turf/open/floor/circuit,
/area/shuttle/chilldown)
"jG" = (
/obj/effect/turf_decal/trimline/yellow/warning{
	dir = 9
	},
/turf/closed/indestructible/reinforced,
/area/shuttle/chilldown)
"jQ" = (
/obj/machinery/atmospherics/pipe/smart/manifold4w/supply/hidden{
	dir = 4
	},
/obj/machinery/light/small/directional/south,
/obj/effect/decal/cleanable/dirt/dust,
/turf/open/floor/pod/dark,
/area/shuttle/chilldown)
"jW" = (
/obj/effect/decal/cleanable/dirt/dust,
/turf/open/floor/mineral/plastitanium,
/area/shuttle/chilldown)
"ko" = (
/obj/structure/reagent_dispensers/watertank,
/obj/item/reagent_containers/glass/bucket,
/turf/open/floor/pod/dark,
/area/shuttle/chilldown)
"kx" = (
/obj/machinery/door/airlock/public/glass,
/turf/open/floor/engine,
/area/shuttle/chilldown)
"ky" = (
/obj/structure/chair/comfy/shuttle{
	dir = 4
	},
/obj/effect/decal/cleanable/dirt/dust,
/turf/open/floor/circuit/off,
/area/shuttle/chilldown)
"kF" = (
/obj/effect/turf_decal/trimline/yellow/warning,
/turf/open/floor/circuit,
/area/shuttle/chilldown)
"kO" = (
/obj/effect/spawner/structure/window/shuttle,
/obj/effect/decal/cleanable/dirt/dust,
/turf/open/floor/plating,
/area/shuttle/chilldown)
"lk" = (
/obj/machinery/atmospherics/components/unary/vent_pump/on{
	dir = 1
	},
/obj/effect/decal/cleanable/dirt/dust,
/turf/open/floor/iron/kitchen_coldroom/freezerfloor,
/area/shuttle/chilldown)
"lL" = (
/obj/effect/turf_decal/trimline/yellow/warning{
	dir = 10
	},
/obj/structure/shuttle/engine/huge{
	dir = 8
	},
/turf/open/floor/plating/airless,
/area/shuttle/chilldown)
"mI" = (
/obj/machinery/atmospherics/pipe/smart/manifold4w/supply/hidden{
	dir = 5
	},
/obj/structure/chair/comfy/shuttle{
	dir = 4
	},
/turf/open/floor/circuit/off,
/area/shuttle/chilldown)
"nd" = (
/obj/structure/closet/crate,
/turf/open/floor/circuit/off,
/area/shuttle/chilldown)
"nB" = (
/obj/machinery/computer/shuttle/chilldown{
	dir = 8
	},
/obj/machinery/light/floor,
/turf/open/floor/circuit/off,
/area/shuttle/chilldown)
"nY" = (
/obj/machinery/door/airlock/external/glass{
	id_tag = "pirateportexternal"
	},
/turf/open/floor/pod/dark,
/area/shuttle/chilldown)
"oU" = (
/turf/closed/indestructible/reinforced,
/area/shuttle/chilldown)
"pk" = (
/obj/effect/turf_decal/trimline/yellow/warning{
	dir = 9
	},
/obj/machinery/mining_laser{
	dir = 9
	},
/turf/open/floor/plating/airless,
/area/shuttle/chilldown)
"pv" = (
/obj/machinery/light/red/directional/north,
/obj/item/stack/conveyor{
	amount = 30
	},
/obj/item/conveyor_switch_construct,
/turf/open/floor/iron/kitchen_coldroom/freezerfloor,
/area/shuttle/chilldown)
"pU" = (
/obj/machinery/door/airlock/silver,
/obj/effect/mapping_helpers/airlock/cutaiwire,
/obj/machinery/atmospherics/pipe/smart/manifold4w/supply/hidden{
	dir = 4
	},
/turf/open/floor/carpet/royalblack,
/area/shuttle/chilldown)
"qc" = (
/obj/machinery/button/door{
	id = "silverbridge";
	name = "Window Shutters Control";
	pixel_y = -5
	},
/turf/closed/wall/mineral/titanium,
/area/shuttle/chilldown)
"qd" = (
/obj/machinery/atmospherics/pipe/smart/manifold4w/supply/hidden{
	dir = 4
	},
/turf/open/floor/iron/kitchen_coldroom/freezerfloor,
/area/shuttle/chilldown)
"qA" = (
/obj/machinery/atmospherics/components/unary/vent_pump/on{
	dir = 1
	},
/obj/machinery/light/directional/east,
/obj/effect/decal/cleanable/dirt/dust,
/turf/open/floor/pod/dark,
/area/shuttle/chilldown)
"qL" = (
/obj/structure/bed/pod,
/obj/item/toy/figure/cargotech,
/turf/open/floor/iron/kitchen_coldroom/freezerfloor,
/area/shuttle/chilldown)
"rB" = (
/turf/closed/wall/mineral/titanium,
/area/shuttle/chilldown)
"ue" = (
/obj/machinery/atmospherics/pipe/smart/manifold4w/supply/hidden{
	dir = 1
	},
/obj/effect/decal/cleanable/dirt/dust,
/turf/open/floor/iron/kitchen_coldroom/freezerfloor,
/area/shuttle/chilldown)
"uX" = (
/obj/effect/decal/cleanable/dirt/dust,
/obj/machinery/light/floor,
/turf/open/floor/iron/kitchen_coldroom/freezerfloor,
/area/shuttle/chilldown)
"vw" = (
/obj/effect/turf_decal/trimline/yellow/warning{
	dir = 10
	},
/turf/open/floor/circuit,
/area/shuttle/chilldown)
"vz" = (
/obj/machinery/atmospherics/pipe/smart/manifold4w/supply/hidden{
	dir = 4
	},
/obj/machinery/computer/camera_advanced/syndie{
	dir = 8
	},
/obj/machinery/light/floor,
/turf/open/floor/circuit/off,
/area/shuttle/chilldown)
"vM" = (
/obj/effect/decal/cleanable/dirt/dust,
/turf/open/floor/circuit/off,
/area/shuttle/chilldown)
"vP" = (
/obj/structure/bed/pod,
/obj/effect/decal/cleanable/dirt/dust,
/turf/open/floor/iron/kitchen_coldroom/freezerfloor,
/area/shuttle/chilldown)
"wa" = (
/obj/machinery/atmospherics/pipe/smart/manifold4w/supply/hidden,
/obj/effect/decal/cleanable/dirt/dust,
/turf/open/floor/iron/kitchen_coldroom/freezerfloor,
/area/shuttle/chilldown)
"xe" = (
/obj/machinery/atmospherics/components/unary/vent_pump/on,
/obj/machinery/light/directional/east,
/obj/effect/decal/cleanable/dirt/dust,
/obj/structure/mopbucket,
/obj/item/mop,
/turf/open/floor/pod/dark,
/area/shuttle/chilldown)
"xs" = (
/obj/effect/spawner/structure/window/shuttle,
/turf/open/floor/plating,
/area/shuttle/chilldown)
"xO" = (
/obj/machinery/button/door{
	id = "silverbridge_cargo";
	name = "Window Shutters Control";
	pixel_y = -5
	},
/turf/closed/wall/mineral/titanium,
/area/shuttle/chilldown)
"xR" = (
/obj/machinery/door/poddoor/shutters/preopen{
	id = "silverbridge"
	},
/obj/effect/spawner/structure/window/shuttle,
/turf/open/floor/plating,
/area/shuttle/chilldown)
"yH" = (
/obj/effect/spawner/lootdrop/crate_spawner,
/turf/open/floor/mineral/plastitanium,
/area/shuttle/chilldown)
"yL" = (
/obj/structure/closet/crate,
/obj/item/toy/toy_xeno,
/obj/item/toy/sprayoncan,
/turf/open/floor/circuit/off,
/area/shuttle/chilldown)
"zB" = (
/obj/structure/fans/tiny,
/obj/machinery/door/poddoor/shutters{
	id = "silverbridge_cargo"
	},
/obj/structure/plasticflaps,
/turf/open/floor/engine,
/area/shuttle/chilldown)
"zN" = (
/obj/machinery/atmospherics/pipe/smart/manifold4w/supply/hidden{
	dir = 4
	},
/obj/machinery/light/small/directional/north,
/obj/effect/decal/cleanable/dirt/dust,
/turf/open/floor/pod/dark,
/area/shuttle/chilldown)
"zQ" = (
/obj/machinery/door/airlock/external/glass{
	id_tag = "piratestarboardexternal"
	},
/obj/machinery/atmospherics/pipe/smart/manifold4w/supply/hidden{
	dir = 4
	},
/obj/effect/decal/cleanable/dirt/dust,
/turf/open/floor/pod/dark,
/area/shuttle/chilldown)
"Ae" = (
/obj/structure/shuttle/engine/propulsion{
	dir = 8
	},
/obj/machinery/light/floor,
/turf/open/floor/circuit/red/anim,
/area/shuttle/chilldown)
"Aj" = (
/obj/structure/chair/sofa/corp/right{
	dir = 1
	},
/obj/machinery/atmospherics/pipe/smart/manifold4w/supply/hidden,
/turf/open/floor/iron/kitchen_coldroom/freezerfloor,
/area/shuttle/chilldown)
"AA" = (
/obj/machinery/atmospherics/pipe/smart/manifold4w/supply/hidden,
/obj/effect/decal/cleanable/dirt/dust,
/turf/open/floor/pod/dark,
/area/shuttle/chilldown)
"AE" = (
/obj/effect/spawner/structure/window/shuttle,
/obj/structure/shuttle/engine/heater{
	dir = 8
	},
/turf/open/space/basic,
/area/shuttle/chilldown)
"AP" = (
/turf/open/floor/circuit/off,
/area/shuttle/chilldown)
"AR" = (
/obj/machinery/atmospherics/components/unary/vent_pump/on{
	dir = 8
	},
/obj/effect/decal/cleanable/dirt/dust,
/turf/open/floor/circuit/off,
/area/shuttle/chilldown)
"BK" = (
/obj/machinery/atmospherics/pipe/smart/manifold4w/supply/hidden{
	dir = 1
	},
/obj/effect/decal/cleanable/dirt/dust,
/turf/open/floor/circuit/off,
/area/shuttle/chilldown)
"BO" = (
/obj/effect/turf_decal/trimline/yellow/warning{
	dir = 9
	},
/turf/open/floor/circuit,
/area/shuttle/chilldown)
"Ch" = (
/obj/machinery/atmospherics/pipe/smart/manifold4w/supply/hidden,
/turf/open/floor/iron/kitchen_coldroom/freezerfloor,
/area/shuttle/chilldown)
"CH" = (
/obj/structure/chair/sofa/corp/left{
	dir = 1
	},
/turf/open/floor/iron/kitchen_coldroom/freezerfloor,
/area/shuttle/chilldown)
"CP" = (
/obj/machinery/power/smes/engineering{
	charge = 1e+006
	},
/obj/structure/cable,
/turf/open/floor/pod/dark,
/area/shuttle/chilldown)
"CW" = (
/obj/structure/lattice/catwalk,
/obj/effect/decal/cleanable/dirt/dust,
/turf/template_noop,
/area/shuttle/chilldown)
"Dg" = (
/obj/machinery/computer/cargo/express{
	dir = 4
	},
/turf/open/floor/iron/kitchen_coldroom/freezerfloor,
/area/shuttle/chilldown)
"Dt" = (
/obj/effect/turf_decal/trimline/yellow/warning{
	dir = 8
	},
/turf/closed/indestructible/reinforced,
/area/shuttle/chilldown)
"Fi" = (
/obj/effect/decal/cleanable/dirt/dust,
/turf/open/floor/iron/kitchen_coldroom/freezerfloor,
/area/shuttle/chilldown)
"Gr" = (
/obj/effect/turf_decal/trimline/yellow/warning{
	dir = 8
	},
/turf/open/floor/plating/airless,
/area/shuttle/chilldown)
"Gy" = (
/obj/machinery/light/small/directional/west,
/turf/open/floor/iron/kitchen_coldroom/freezerfloor,
/area/shuttle/chilldown)
"GT" = (
/obj/effect/decal/cleanable/robot_debris/down,
/turf/open/floor/circuit/off,
/area/shuttle/chilldown)
"HD" = (
/obj/effect/spawner/structure/window/shuttle,
/obj/machinery/door/poddoor/shutters/preopen{
	id = "silverbridge"
	},
/turf/open/floor/plating,
/area/shuttle/chilldown)
"HO" = (
/obj/machinery/light/red/directional/west,
/turf/open/floor/iron/kitchen_coldroom/freezerfloor,
/area/shuttle/chilldown)
"HS" = (
/obj/structure/closet/crate,
/turf/open/floor/iron/kitchen_coldroom/freezerfloor,
/area/shuttle/chilldown)
"Ig" = (
/obj/effect/spawner/structure/window/shuttle,
/obj/machinery/atmospherics/pipe/smart/manifold4w/supply/hidden,
/obj/item/radio/intercom{
	pixel_y = 5
	},
/turf/open/floor/plating,
/area/shuttle/chilldown)
"Jq" = (
/obj/machinery/atmospherics/pipe/smart/manifold4w/supply/hidden{
	dir = 6
	},
/turf/open/floor/circuit/off,
/area/shuttle/chilldown)
"JL" = (
/obj/structure/bookcase/random/nonfiction,
/turf/open/floor/iron/kitchen_coldroom/freezerfloor,
/area/shuttle/chilldown)
"JV" = (
/obj/machinery/atmospherics/pipe/smart/manifold4w/supply/hidden,
/turf/open/floor/circuit/off,
/area/shuttle/chilldown)
"Kq" = (
/obj/machinery/light/directional/west,
/obj/effect/decal/cleanable/dirt/dust,
/turf/open/floor/iron/kitchen_coldroom/freezerfloor,
/area/shuttle/chilldown)
"Lb" = (
/obj/structure/bed/pod,
/turf/open/floor/iron/kitchen_coldroom/freezerfloor,
/area/shuttle/chilldown)
"Lk" = (
/obj/machinery/power/terminal{
	dir = 1
	},
/obj/structure/cable,
/obj/machinery/atmospherics/pipe/smart/manifold4w/supply/hidden{
	dir = 6
	},
/obj/effect/decal/cleanable/dirt/dust,
/obj/effect/decal/cleanable/greenglow,
/turf/open/floor/pod/dark,
/area/shuttle/chilldown)
"Lm" = (
/obj/machinery/light/red/directional/south,
/obj/effect/decal/cleanable/dirt/dust,
/turf/open/floor/iron/kitchen_coldroom/freezerfloor,
/area/shuttle/chilldown)
"LQ" = (
/obj/machinery/atmospherics/components/unary/vent_pump/on,
/turf/open/floor/circuit/off,
/area/shuttle/chilldown)
"Mo" = (
/obj/structure/fans/tiny,
/obj/machinery/door/poddoor/shutters{
	id = "silverbridge_cargo"
	},
/turf/open/floor/engine,
/area/shuttle/chilldown)
"Mu" = (
/turf/open/floor/plating/airless,
/area/shuttle/chilldown)
"MA" = (
/obj/machinery/atmospherics/components/unary/vent_pump/on{
	dir = 1
	},
/turf/open/floor/circuit/off,
/area/shuttle/chilldown)
"Ni" = (
/obj/effect/decal/cleanable/robot_debris/up,
/turf/open/floor/engine,
/area/shuttle/chilldown)
"Ox" = (
/obj/machinery/atmospherics/components/unary/vent_pump/on{
	dir = 8
	},
/obj/effect/decal/cleanable/dirt/dust,
/turf/open/floor/iron/kitchen_coldroom/freezerfloor,
/area/shuttle/chilldown)
"OI" = (
/obj/effect/decal/cleanable/dirt/dust,
/obj/effect/spawner/lootdrop/crate_spawner,
/turf/open/floor/mineral/plastitanium,
/area/shuttle/chilldown)
"OT" = (
/obj/machinery/door/airlock/silver,
/obj/effect/mapping_helpers/airlock/cutaiwire,
/turf/open/floor/pod/dark,
/area/shuttle/chilldown)
"Pg" = (
/obj/machinery/atmospherics/pipe/smart/manifold4w/supply/hidden{
	dir = 1
	},
/obj/effect/decal/cleanable/dirt/dust,
/turf/open/floor/pod/dark,
/area/shuttle/chilldown)
"Qi" = (
/obj/machinery/atmospherics/pipe/smart/manifold4w/supply/hidden{
	dir = 4
	},
/turf/open/floor/circuit/off,
/area/shuttle/chilldown)
"Qm" = (
/turf/open/floor/iron/kitchen_coldroom/freezerfloor,
/area/shuttle/chilldown)
"QE" = (
/obj/structure/fans/tiny,
/obj/structure/plasticflaps,
/obj/machinery/door/poddoor/shutters{
	id = "silverbridge_cargo"
	},
/turf/open/floor/engine,
/area/shuttle/chilldown)
"QI" = (
/obj/machinery/atmospherics/components/unary/tank/air,
/obj/effect/decal/cleanable/dirt/dust,
/turf/open/floor/pod/dark,
/area/shuttle/chilldown)
"QO" = (
/obj/machinery/atmospherics/pipe/smart/manifold4w/supply/hidden{
	dir = 10
	},
/obj/effect/decal/cleanable/dirt/dust,
/turf/open/floor/circuit/off,
/area/shuttle/chilldown)
"QU" = (
/obj/structure/cable,
/obj/machinery/power/apc/auto_name/north,
/obj/structure/rack,
/obj/item/storage/toolbox/mechanical{
	pixel_y = 4
	},
/obj/item/flashlight/seclite,
/obj/item/storage/box/lights/bulbs,
/obj/item/stack/sheet/mineral/plasma{
	amount = 10
	},
/obj/item/multitool,
/turf/open/floor/pod/dark,
/area/shuttle/chilldown)
"RE" = (
/obj/machinery/atmospherics/pipe/smart/manifold4w/supply/hidden{
	dir = 9
	},
/turf/open/floor/circuit/off,
/area/shuttle/chilldown)
"RY" = (
/obj/machinery/light/directional/east,
/turf/open/floor/iron/kitchen_coldroom/freezerfloor,
/area/shuttle/chilldown)
"Sh" = (
/obj/effect/turf_decal/trimline/yellow/warning{
	dir = 1
	},
/turf/open/floor/circuit,
/area/shuttle/chilldown)
"Si" = (
/obj/machinery/atmospherics/pipe/smart/manifold4w/supply/hidden{
	dir = 4
	},
/obj/effect/decal/cleanable/dirt/dust,
/turf/open/floor/pod/dark,
/area/shuttle/chilldown)
"Su" = (
/obj/machinery/power/port_gen/pacman{
	anchored = 1
	},
/obj/structure/cable,
/turf/open/floor/pod/dark,
/area/shuttle/chilldown)
"Sv" = (
/obj/machinery/atmospherics/pipe/smart/manifold4w/supply/hidden{
	dir = 4
	},
/obj/effect/decal/cleanable/dirt/dust,
/turf/open/floor/circuit/off,
/area/shuttle/chilldown)
"TT" = (
/obj/machinery/atmospherics/components/unary/vent_pump/on{
	dir = 4
	},
/turf/open/floor/pod/dark,
/area/shuttle/chilldown)
"TV" = (
/obj/effect/turf_decal/trimline/yellow/warning{
	dir = 10
	},
/obj/machinery/mining_laser{
	dir = 10
	},
/turf/open/floor/plating/airless,
/area/shuttle/chilldown)
"Uf" = (
/obj/effect/decal/cleanable/robot_debris/old,
/obj/effect/decal/cleanable/plastic,
/turf/open/floor/iron/kitchen_coldroom/freezerfloor,
/area/shuttle/chilldown)
"Ut" = (
/obj/structure/rack,
/turf/open/floor/iron/kitchen_coldroom/freezerfloor,
/area/shuttle/chilldown)
"UJ" = (
/obj/structure/shuttle/engine/propulsion{
	dir = 8
	},
/obj/effect/turf_decal/trimline/yellow/warning{
	dir = 8
	},
/turf/open/floor/plating/airless,
/area/shuttle/chilldown)
"Ww" = (
/obj/structure/shuttle/engine/heater{
	dir = 8
	},
/turf/open/floor/plating/airless,
/area/shuttle/chilldown)
"Wy" = (
/obj/structure/reagent_dispensers/fueltank,
/turf/open/floor/pod/dark,
/area/shuttle/chilldown)
"WE" = (
/obj/structure/sign/warning/coldtemp,
/turf/closed/wall/mineral/titanium,
/area/shuttle/chilldown)
"Xb" = (
/obj/effect/decal/cleanable/dirt,
/turf/open/floor/engine,
/area/shuttle/chilldown)
"Xw" = (
/turf/open/floor/mineral/plastitanium,
/area/shuttle/chilldown)
"XB" = (
/obj/machinery/light/small/directional/south,
/turf/open/floor/circuit/off,
/area/shuttle/chilldown)
"XX" = (
/obj/structure/bookcase/random/fiction,
/turf/open/floor/iron/kitchen_coldroom/freezerfloor,
/area/shuttle/chilldown)
"Yz" = (
/obj/structure/lattice/catwalk,
/turf/template_noop,
/area/shuttle/chilldown)
"YE" = (
/obj/machinery/light/floor,
/turf/open/floor/iron/kitchen_coldroom/freezerfloor,
/area/shuttle/chilldown)
"YL" = (
/obj/structure/curtain/bounty,
/obj/machinery/shower{
	dir = 1
	},
/turf/open/floor/circuit,
/area/shuttle/chilldown)
"ZD" = (
/obj/machinery/door/airlock/silver/glass,
/obj/effect/mapping_helpers/airlock/cutaiwire,
/turf/open/floor/iron/kitchen_coldroom/freezerfloor,
/area/shuttle/chilldown)

(1,1,1) = {"
je
je
WE
nY
rB
Gr
Gr
lL
je
jG
Dt
Dt
oU
jm
WE
je
je
"}
(2,1,1) = {"
je
BO
rB
TT
rB
Mu
Mu
Mu
UJ
oU
iv
Xb
oU
he
rB
vw
je
"}
(3,1,1) = {"
je
AE
rB
jQ
hr
Ww
Ww
Ww
eK
oU
Xb
Ni
oU
zN
rB
AE
je
"}
(4,1,1) = {"
pk
rB
rB
de
rB
HD
HD
HD
rB
xs
kx
kx
rB
zQ
rB
rB
TV
"}
(5,1,1) = {"
rB
rB
Su
Si
rB
aZ
aZ
aZ
Uf
Dg
Qm
Qm
rB
Si
QI
rB
rB
"}
(6,1,1) = {"
rB
CP
Lk
Si
ht
wa
wa
wa
hW
wa
wa
Ch
cH
Si
AA
ko
rB
"}
(7,1,1) = {"
rB
QU
Pg
qA
rB
RY
Qm
Fi
Ox
Fi
Fi
RY
rB
xe
AA
Wy
rB
"}
(8,1,1) = {"
rB
rB
au
WE
rB
rB
OT
rB
rB
rB
OT
rB
rB
WE
au
rB
rB
"}
(9,1,1) = {"
HD
JL
fT
cE
xO
HS
Qm
iY
HO
gg
Qm
aA
kO
Kq
qd
Gy
HD
"}
(10,1,1) = {"
HD
Ut
fT
CH
xs
HS
Xw
Xw
jW
jW
Xw
dT
xs
Fi
fT
Qm
HD
"}
(11,1,1) = {"
qc
Qm
ue
lk
ZD
Qm
Xw
yH
yH
jW
jW
Qm
ZD
ei
wa
Qm
rB
"}
(12,1,1) = {"
HD
Qm
ue
Aj
jo
jj
jW
Xw
Xw
jW
OI
ei
Ig
Ch
Ch
Fi
HD
"}
(13,1,1) = {"
HD
XX
qd
CH
xs
pv
YE
Fi
Qm
Fi
uX
Lm
xs
Qm
qd
Fi
HD
"}
(14,1,1) = {"
rB
rB
pU
rB
rB
zB
Mo
Mo
fH
fH
Mo
QE
rB
rB
pU
rB
rB
"}
(15,1,1) = {"
xs
vM
Sv
XB
WE
kF
AP
vM
es
vM
vM
Sh
WE
fN
Qi
YL
rB
"}
(16,1,1) = {"
xs
AP
BK
MA
xR
jv
vM
CW
Yz
CW
iy
jv
HD
LQ
JV
YL
rB
"}
(17,1,1) = {"
xs
ky
QO
mI
HD
je
vM
Yz
CW
CW
vM
je
HD
Jq
RE
YL
rB
"}
(18,1,1) = {"
xs
nB
GT
vz
rB
je
AP
CW
CW
Yz
iy
je
rB
Qi
vP
Lb
rB
"}
(19,1,1) = {"
xs
xs
xs
xs
rB
je
AP
CW
Yz
Yz
iy
je
rB
Sv
Qm
Qm
rB
"}
(20,1,1) = {"
je
je
je
je
rB
je
es
Yz
Yz
Yz
bk
je
rB
AR
hO
Lb
rB
"}
(21,1,1) = {"
je
je
je
je
rB
je
je
je
je
je
je
je
rB
vM
Fi
Fi
rB
"}
(22,1,1) = {"
je
je
je
je
rB
je
je
je
je
je
je
je
rB
AP
Lb
qL
rB
"}
(23,1,1) = {"
je
je
je
je
rB
Ae
je
je
je
je
je
Ae
rB
vM
vM
vM
rB
"}
(24,1,1) = {"
je
je
je
je
rB
je
je
je
je
je
je
je
rB
vM
nd
yL
rB
"}
(25,1,1) = {"
je
je
je
je
rB
Ae
je
je
je
je
je
Ae
rB
rB
rB
rB
rB
"}
(26,1,1) = {"
je
je
je
je
rB
je
je
je
je
je
je
je
rB
je
je
je
je
"}
(27,1,1) = {"
je
je
je
je
rB
Ae
je
je
je
je
je
Ae
rB
je
je
je
je
"}
