//MAP CONVERTED BY dmm2tgm.py THIS HEADER COMMENT PREVENTS RECONVERSION, DO NOT REMOVE
"an" = (
/obj/machinery/teleport/hub,
/turf/open/floor/carpet/stellar,
/area/shuttle/aggregeddon)
"au" = (
/obj/machinery/light/cold/no_nightlight/directional/west,
/turf/open/floor/mineral/plastitanium/red,
/area/shuttle/aggregeddon)
"aE" = (
/obj/structure/cable,
/obj/machinery/bsa/front,
/turf/open/floor/iron/freezer,
/area/shuttle/aggregeddon)
"aX" = (
/obj/structure/closet/secure_closet/ert_engi,
/obj/machinery/light/cold/no_nightlight/directional/north,
/turf/open/floor/mineral/titanium/tiled/yellow,
/area/shuttle/aggregeddon)
"bl" = (
/obj/docking_port/mobile{
	dir = 4;
	dwidth = 13;
	height = 3;
	id = "aggregeddon";
	launch_status = 0;
	movement_force = list("KNOCKDOWN" = 0, "THROW" = 0);
	name = "Supercruiser Aggregeddon";
	preferred_direction = 8;
	width = 26
	},
/obj/machinery/door/airlock/external/glass{
	id_tag = "piratestarboardexternal"
	},
/obj/structure/fans/tiny,
/obj/structure/fans/tiny,
/obj/structure/fans/tiny,
/turf/open/floor/engine,
/area/shuttle/aggregeddon)
"bB" = (
/obj/structure/chair/comfy/shuttle,
/turf/open/floor/carpet/executive,
/area/shuttle/aggregeddon)
"cG" = (
/obj/machinery/light/floor,
/obj/item/beacon,
/turf/open/floor/carpet/stellar,
/area/shuttle/aggregeddon)
"cJ" = (
/turf/open/floor/mineral/titanium/tiled/yellow,
/area/shuttle/aggregeddon)
"cL" = (
/obj/machinery/light/cold/no_nightlight/directional/west,
/obj/structure/closet/crate/rcd,
/turf/open/floor/circuit/red/anim,
/area/shuttle/aggregeddon)
"cR" = (
/obj/structure/closet/radiation,
/turf/open/floor/mineral/titanium/tiled/yellow,
/area/shuttle/aggregeddon)
"cW" = (
/obj/structure/table/reinforced,
/obj/item/gun/energy/laser,
/turf/open/floor/engine,
/area/shuttle/aggregeddon)
"dk" = (
/obj/machinery/door/poddoor/shutters{
	id = "mechdoors"
	},
/obj/machinery/light/floor,
/turf/open/floor/engine,
/area/shuttle/aggregeddon)
"dm" = (
/obj/machinery/computer/teleporter,
/turf/open/floor/carpet/stellar,
/area/shuttle/aggregeddon)
"ds" = (
/obj/structure/chair/comfy/shuttle,
/turf/open/floor/circuit/red/anim,
/area/shuttle/aggregeddon)
"dy" = (
/turf/open/space/basic,
/area/template_noop)
"dA" = (
/turf/open/floor/plating,
/area/shuttle/aggregeddon)
"dC" = (
/obj/machinery/stasis{
	dir = 8
	},
/obj/structure/curtain/bounty,
/turf/open/floor/mineral/titanium/blue,
/area/shuttle/aggregeddon)
"dI" = (
/obj/structure/shuttle/engine/heater{
	dir = 8
	},
/turf/open/floor/plating,
/area/shuttle/aggregeddon)
"dS" = (
/obj/machinery/bsa/middle,
/turf/open/floor/iron/freezer,
/area/shuttle/aggregeddon)
"eq" = (
/obj/machinery/light/cold/no_nightlight/directional/north,
/turf/open/floor/engine,
/area/shuttle/aggregeddon)
"eu" = (
/obj/machinery/light/floor,
/turf/open/floor/carpet/blue,
/area/shuttle/aggregeddon)
"fB" = (
/obj/structure/closet/secure_closet/engineering_welding,
/turf/open/floor/mineral/titanium/tiled/yellow,
/area/shuttle/aggregeddon)
"gh" = (
/obj/machinery/computer/shuttle/supercruiser_aggregeddon{
	dir = 8
	},
/turf/open/floor/circuit,
/area/shuttle/aggregeddon)
"gn" = (
/obj/machinery/computer/crew{
	dir = 1
	},
/turf/open/floor/carpet/stellar,
/area/shuttle/aggregeddon)
"gu" = (
/obj/structure/cable,
/obj/machinery/bsa/back,
/turf/open/floor/iron/freezer,
/area/shuttle/aggregeddon)
"gO" = (
/turf/closed/wall/mineral/plastitanium,
/area/shuttle/aggregeddon)
"hl" = (
/obj/machinery/shieldgen,
/turf/open/floor/mineral/plastitanium/red,
/area/shuttle/aggregeddon)
"hn" = (
/turf/open/floor/engine,
/area/shuttle/aggregeddon)
"ik" = (
/obj/structure/closet/secure_closet/ert_med,
/turf/open/floor/mineral/titanium/blue,
/area/shuttle/aggregeddon)
"iC" = (
/obj/structure/table/reinforced,
/obj/item/storage/backpack/duffelbag/med/surgery,
/turf/open/floor/mineral/titanium/blue,
/area/shuttle/aggregeddon)
"iL" = (
/obj/structure/cable,
/obj/machinery/power/apc/auto_name/west,
/obj/structure/closet/secure_closet/ert_com,
/turf/open/floor/carpet/stellar,
/area/shuttle/aggregeddon)
"iS" = (
/obj/structure/table/reinforced,
/obj/item/gun/energy/pulse/pistol/m1911,
/turf/open/floor/engine,
/area/shuttle/aggregeddon)
"iT" = (
/obj/machinery/modular_computer/console/preset/id/centcom{
	dir = 8
	},
/obj/structure/railing,
/turf/open/floor/circuit,
/area/shuttle/aggregeddon)
"iV" = (
/obj/effect/spawner/lootdrop/melee_weapon,
/turf/open/floor/mineral/titanium/tiled/yellow,
/area/shuttle/aggregeddon)
"jH" = (
/obj/machinery/computer/operating{
	dir = 1
	},
/turf/open/floor/mineral/titanium/blue,
/area/shuttle/aggregeddon)
"kd" = (
/obj/machinery/smartfridge/organ,
/turf/open/floor/carpet/blue,
/area/shuttle/aggregeddon)
"kt" = (
/obj/machinery/light/cold/no_nightlight/directional/north,
/turf/open/floor/mineral/plastitanium/red,
/area/shuttle/aggregeddon)
"kx" = (
/obj/structure/cable,
/turf/open/floor/mineral/plastitanium/red,
/area/shuttle/aggregeddon)
"kB" = (
/obj/structure/closet/secure_closet/ert_sec,
/turf/open/floor/mineral/plastitanium/red,
/area/shuttle/aggregeddon)
"kH" = (
/obj/machinery/power/apc/auto_name/north,
/turf/open/floor/circuit/red/anim,
/area/shuttle/aggregeddon)
"kM" = (
/obj/machinery/button{
	id = "mechdoors"
	},
/turf/closed/wall/mineral/plastitanium,
/area/shuttle/aggregeddon)
"kZ" = (
/obj/machinery/button{
	id = "gundoors"
	},
/turf/closed/wall/mineral/titanium,
/area/shuttle/aggregeddon)
"lp" = (
/obj/structure/table/optable,
/turf/open/floor/mineral/titanium/blue,
/area/shuttle/aggregeddon)
"lv" = (
/obj/structure/cable,
/obj/structure/cable,
/turf/open/floor/iron/freezer,
/area/shuttle/aggregeddon)
"lx" = (
/obj/machinery/shield_generator,
/turf/open/floor/carpet/stellar,
/area/shuttle/aggregeddon)
"lA" = (
/obj/machinery/light/cold/no_nightlight/directional/north,
/turf/open/floor/mineral/titanium/tiled/yellow,
/area/shuttle/aggregeddon)
"lG" = (
/obj/machinery/power/emitter/welded{
	dir = 4
	},
/obj/structure/cable,
/turf/open/floor/engine,
/area/shuttle/aggregeddon)
"mc" = (
/obj/structure/chair/office,
/turf/open/floor/mineral/titanium/blue,
/area/shuttle/aggregeddon)
"mi" = (
/obj/structure/cable,
/turf/open/floor/iron/freezer,
/area/shuttle/aggregeddon)
"mA" = (
/obj/structure/reflector/box/anchored,
/obj/structure/cable,
/obj/machinery/light/floor,
/obj/machinery/light/cold/no_nightlight/directional/north,
/turf/open/floor/engine,
/area/shuttle/aggregeddon)
"mD" = (
/obj/structure/window/plasma/reinforced/plastitanium,
/turf/open/floor/engine,
/area/shuttle/aggregeddon)
"mT" = (
/obj/machinery/shieldgen,
/turf/open/floor/carpet/stellar,
/area/shuttle/aggregeddon)
"mX" = (
/obj/machinery/light/floor,
/turf/open/floor/mineral/titanium/tiled/yellow,
/area/shuttle/aggregeddon)
"mZ" = (
/obj/machinery/light/cold/no_nightlight/directional/south,
/turf/open/floor/circuit/off,
/area/shuttle/aggregeddon)
"no" = (
/obj/machinery/airalarm/directional/north,
/turf/open/floor/engine,
/area/shuttle/aggregeddon)
"nS" = (
/obj/structure/railing{
	dir = 1
	},
/obj/structure/chair/comfy/shuttle{
	dir = 4
	},
/turf/open/floor/carpet/executive,
/area/shuttle/aggregeddon)
"oa" = (
/obj/machinery/bsa/front,
/turf/open/floor/iron/freezer,
/area/shuttle/aggregeddon)
"oC" = (
/obj/structure/cable,
/obj/machinery/light/floor,
/obj/machinery/door/poddoor/shutters{
	id = "gundoors"
	},
/turf/open/floor/engine,
/area/shuttle/aggregeddon)
"oJ" = (
/turf/open/floor/carpet/stellar,
/area/shuttle/aggregeddon)
"pg" = (
/obj/structure/cable,
/obj/machinery/light/floor,
/turf/open/floor/iron/freezer,
/area/shuttle/aggregeddon)
"pq" = (
/obj/structure/grille,
/obj/structure/window/plasma/reinforced/plastitanium,
/obj/machinery/door/poddoor/shutters/radiation{
	id = "smengineshutter"
	},
/turf/open/floor/engine,
/area/shuttle/aggregeddon)
"pw" = (
/turf/open/floor/circuit,
/area/shuttle/aggregeddon)
"pF" = (
/obj/structure/closet/secure_closet/ert_sec,
/obj/machinery/light/cold/no_nightlight/directional/east,
/turf/open/floor/mineral/plastitanium/red,
/area/shuttle/aggregeddon)
"pG" = (
/obj/machinery/airalarm/directional/north,
/obj/machinery/door/airlock/security/glass,
/turf/open/floor/engine,
/area/shuttle/aggregeddon)
"qx" = (
/obj/item/beacon,
/turf/open/floor/carpet/stellar,
/area/shuttle/aggregeddon)
"qO" = (
/turf/open/floor/iron/freezer,
/area/shuttle/aggregeddon)
"rz" = (
/obj/structure/chair/comfy/shuttle,
/obj/machinery/light/floor,
/turf/open/floor/circuit/red/anim,
/area/shuttle/aggregeddon)
"rB" = (
/obj/machinery/power/apc/auto_name/west,
/turf/open/floor/carpet/stellar,
/area/shuttle/aggregeddon)
"rG" = (
/obj/structure/table/reinforced,
/obj/item/stack/sheet/mineral/plasma/thirty,
/obj/machinery/light/cold/no_nightlight/directional/west,
/turf/open/floor/engine,
/area/shuttle/aggregeddon)
"rJ" = (
/obj/machinery/light/cold/no_nightlight/directional/east,
/turf/open/floor/carpet/stellar,
/area/shuttle/aggregeddon)
"rR" = (
/obj/machinery/shieldgen,
/turf/open/floor/engine,
/area/shuttle/aggregeddon)
"sp" = (
/obj/structure/closet/crate/maint,
/turf/open/floor/circuit/red/anim,
/area/shuttle/aggregeddon)
"sI" = (
/obj/machinery/modular_computer/console/preset/command{
	dir = 1
	},
/obj/structure/railing{
	dir = 4
	},
/obj/machinery/light/cold/no_nightlight/directional/south,
/turf/open/floor/circuit,
/area/shuttle/aggregeddon)
"sM" = (
/obj/machinery/suit_storage_unit/ert/command,
/turf/open/floor/carpet/stellar,
/area/shuttle/aggregeddon)
"tV" = (
/obj/machinery/airalarm/directional/west,
/obj/structure/cable,
/turf/open/floor/engine,
/area/shuttle/aggregeddon)
"ue" = (
/obj/structure/cable,
/obj/machinery/power/port_gen/pacman,
/turf/open/floor/engine,
/area/shuttle/aggregeddon)
"uM" = (
/obj/machinery/light/cold/no_nightlight/directional/north,
/turf/open/floor/circuit/off,
/area/shuttle/aggregeddon)
"uR" = (
/obj/machinery/light/cold/no_nightlight/directional/south,
/turf/open/floor/engine,
/area/shuttle/aggregeddon)
"uT" = (
/obj/machinery/modular_computer/console/preset/engineering{
	dir = 8
	},
/obj/structure/railing{
	dir = 1
	},
/turf/open/floor/circuit,
/area/shuttle/aggregeddon)
"vc" = (
/obj/structure/chair/office{
	dir = 1
	},
/turf/open/floor/carpet/stellar,
/area/shuttle/aggregeddon)
"vo" = (
/obj/structure/closet/crate/medical,
/turf/open/floor/mineral/titanium/blue,
/area/shuttle/aggregeddon)
"vy" = (
/obj/structure/shuttle/engine/large{
	dir = 8
	},
/turf/open/floor/plating,
/area/shuttle/aggregeddon)
"vP" = (
/obj/structure/cable,
/turf/closed/wall/mineral/titanium,
/area/shuttle/aggregeddon)
"vW" = (
/obj/machinery/power/apc/auto_name/north,
/obj/machinery/computer/bsa_control,
/turf/open/floor/circuit/red/anim,
/area/shuttle/aggregeddon)
"wt" = (
/obj/machinery/modular_computer/console/preset/civilian,
/obj/structure/railing{
	dir = 8
	},
/obj/structure/railing{
	dir = 4
	},
/obj/structure/cable,
/turf/open/floor/circuit,
/area/shuttle/aggregeddon)
"wv" = (
/obj/effect/spawner/lootdrop/handgun,
/turf/open/floor/mineral/titanium/tiled/yellow,
/area/shuttle/aggregeddon)
"wx" = (
/obj/machinery/power/supermatter_crystal/shard/engine,
/turf/open/floor/plating/planetary/water/chlorine{
	name = "nuclear waste"
	},
/area/shuttle/aggregeddon)
"wD" = (
/obj/structure/closet/crate/science,
/turf/open/floor/circuit/red/anim,
/area/shuttle/aggregeddon)
"wI" = (
/obj/machinery/power/apc/auto_name/north,
/turf/open/floor/mineral/titanium/blue,
/area/shuttle/aggregeddon)
"wU" = (
/obj/structure/grille,
/obj/structure/window/plasma/reinforced/fulltile,
/turf/open/floor/engine,
/area/shuttle/aggregeddon)
"xg" = (
/obj/structure/cable,
/obj/structure/fans/tiny,
/turf/open/indestructible/hierophant,
/area/shuttle/aggregeddon)
"xE" = (
/obj/structure/sign/directions/medical,
/turf/closed/wall/mineral/titanium,
/area/shuttle/aggregeddon)
"xH" = (
/obj/machinery/light/cold/no_nightlight/directional/west,
/turf/open/floor/engine,
/area/shuttle/aggregeddon)
"xI" = (
/obj/machinery/airalarm/directional/west,
/obj/machinery/door/airlock/security/glass,
/turf/open/floor/engine,
/area/shuttle/aggregeddon)
"xM" = (
/obj/machinery/light/cold/no_nightlight/directional/east,
/turf/open/floor/engine,
/area/shuttle/aggregeddon)
"xO" = (
/turf/closed/wall/mineral/titanium,
/area/shuttle/aggregeddon)
"xQ" = (
/obj/structure/cable,
/obj/machinery/light/cold/no_nightlight/directional/north,
/turf/open/floor/mineral/plastitanium/red,
/area/shuttle/aggregeddon)
"xR" = (
/obj/machinery/light/floor,
/turf/open/floor/mineral/titanium/blue,
/area/shuttle/aggregeddon)
"zq" = (
/obj/machinery/teleport/station,
/turf/open/floor/carpet/stellar,
/area/shuttle/aggregeddon)
"Ad" = (
/obj/machinery/door/airlock/security/glass,
/turf/open/floor/engine,
/area/shuttle/aggregeddon)
"Ah" = (
/obj/structure/window/plasma/reinforced/fulltile,
/obj/structure/fans/tiny,
/turf/open/indestructible/hierophant,
/area/shuttle/aggregeddon)
"Av" = (
/obj/machinery/light/floor,
/turf/open/floor/engine,
/area/shuttle/aggregeddon)
"AJ" = (
/obj/structure/table/reinforced,
/obj/item/gun/energy/ionrifle,
/turf/open/floor/engine,
/area/shuttle/aggregeddon)
"AL" = (
/obj/machinery/button{
	id = "gundoors"
	},
/turf/closed/wall/mineral/plastitanium,
/area/shuttle/aggregeddon)
"AV" = (
/obj/structure/cable,
/obj/machinery/power/rad_collector/anchored,
/turf/open/floor/engine,
/area/shuttle/aggregeddon)
"Bf" = (
/obj/machinery/light/cold/no_nightlight/directional/south,
/turf/open/floor/carpet/stellar,
/area/shuttle/aggregeddon)
"Bh" = (
/obj/structure/closet/radiation,
/obj/machinery/light/cold/no_nightlight/directional/west,
/turf/open/floor/mineral/titanium/tiled/yellow,
/area/shuttle/aggregeddon)
"Ce" = (
/obj/effect/spawner/lootdrop/medkit,
/turf/open/floor/mineral/titanium/tiled/yellow,
/area/shuttle/aggregeddon)
"Co" = (
/obj/machinery/light/floor,
/turf/open/floor/iron/freezer,
/area/shuttle/aggregeddon)
"CO" = (
/obj/structure/chair/comfy/shuttle,
/turf/open/floor/engine,
/area/shuttle/aggregeddon)
"Dl" = (
/obj/machinery/computer/bsa_control,
/turf/open/floor/circuit/red/anim,
/area/shuttle/aggregeddon)
"DV" = (
/obj/structure/fans/tiny,
/turf/open/indestructible/hierophant,
/area/shuttle/aggregeddon)
"Ee" = (
/obj/structure/shuttle/engine/huge{
	dir = 8
	},
/turf/open/floor/plating,
/area/shuttle/aggregeddon)
"Ez" = (
/obj/structure/chair/comfy/shuttle{
	dir = 4
	},
/turf/open/floor/carpet/executive,
/area/shuttle/aggregeddon)
"EU" = (
/obj/machinery/light/cold/no_nightlight/directional/west,
/turf/open/floor/circuit/red/anim,
/area/shuttle/aggregeddon)
"Fl" = (
/obj/structure/closet/crate/secure/gear,
/turf/open/floor/mineral/plastitanium/red,
/area/shuttle/aggregeddon)
"FD" = (
/obj/structure/cable,
/obj/machinery/bsa/middle,
/turf/open/floor/iron/freezer,
/area/shuttle/aggregeddon)
"Gy" = (
/obj/machinery/light/cold/no_nightlight/directional/west,
/turf/open/floor/carpet/stellar,
/area/shuttle/aggregeddon)
"GC" = (
/turf/open/floor/circuit/off,
/area/shuttle/aggregeddon)
"GO" = (
/obj/machinery/airalarm/directional/west,
/obj/structure/table/reinforced,
/obj/machinery/keycard_auth,
/turf/open/floor/carpet/stellar,
/area/shuttle/aggregeddon)
"GY" = (
/obj/structure/table/reinforced,
/obj/item/storage/box/zipties,
/obj/item/clothing/suit/straight_jacket,
/turf/open/floor/mineral/titanium/blue,
/area/shuttle/aggregeddon)
"Hi" = (
/obj/structure/table/reinforced,
/obj/item/gun/energy/pulse,
/turf/open/floor/engine,
/area/shuttle/aggregeddon)
"Hw" = (
/obj/item/stack/sheet/mineral/plasma/thirty,
/obj/structure/table/reinforced,
/turf/open/floor/engine,
/area/shuttle/aggregeddon)
"HF" = (
/turf/open/indestructible/hierophant,
/area/shuttle/aggregeddon)
"HQ" = (
/obj/structure/window/plasma/reinforced/fulltile,
/turf/open/floor/engine,
/area/shuttle/aggregeddon)
"HV" = (
/obj/machinery/vending/medical,
/obj/machinery/light/cold/no_nightlight/directional/east,
/turf/open/floor/mineral/titanium/blue,
/area/shuttle/aggregeddon)
"Ip" = (
/obj/structure/cable,
/turf/open/floor/circuit/red/anim,
/area/shuttle/aggregeddon)
"Iz" = (
/obj/structure/tank_dispenser,
/turf/open/floor/plating,
/area/shuttle/aggregeddon)
"ID" = (
/obj/machinery/keycard_auth,
/turf/closed/wall/mineral/plastitanium,
/area/shuttle/aggregeddon)
"IQ" = (
/obj/structure/chair/comfy/shuttle{
	dir = 1
	},
/obj/machinery/light/floor,
/turf/open/floor/circuit/red/anim,
/area/shuttle/aggregeddon)
"Jg" = (
/obj/structure/cable,
/obj/machinery/shieldgen,
/turf/open/floor/carpet/stellar,
/area/shuttle/aggregeddon)
"Jz" = (
/obj/structure/table/reinforced,
/obj/item/gun/energy/laser/hellgun,
/turf/open/floor/engine,
/area/shuttle/aggregeddon)
"JP" = (
/obj/structure/grille,
/obj/structure/window/plasma/reinforced/plastitanium,
/obj/machinery/door/poddoor/shutters/radiation{
	id = "gunports"
	},
/turf/open/floor/engine,
/area/shuttle/aggregeddon)
"JX" = (
/obj/machinery/door/airlock/command,
/turf/open/floor/engine,
/area/shuttle/aggregeddon)
"JY" = (
/obj/structure/table/reinforced,
/obj/item/clothing/head/helmet/space/chronos/hrvfoxcat,
/obj/item/clothing/suit/space/chronos/hrvfoxcat,
/obj/item/gun/energy/minigun,
/turf/open/floor/engine,
/area/shuttle/aggregeddon)
"JZ" = (
/obj/machinery/light/floor,
/obj/structure/closet/secure_closet/ert_engi,
/turf/open/floor/engine,
/area/shuttle/aggregeddon)
"KL" = (
/obj/machinery/modular_computer/console/preset/engineering{
	dir = 1
	},
/turf/open/floor/carpet/stellar,
/area/shuttle/aggregeddon)
"Lu" = (
/obj/structure/table/optable,
/obj/machinery/light/cold/no_nightlight/directional/south,
/turf/open/floor/mineral/titanium/blue,
/area/shuttle/aggregeddon)
"LA" = (
/obj/machinery/power/apc/auto_name/east,
/turf/open/floor/engine,
/area/shuttle/aggregeddon)
"LF" = (
/obj/vehicle/sealed/mecha/combat/marauder/seraph,
/turf/open/floor/engine,
/area/shuttle/aggregeddon)
"LQ" = (
/obj/structure/closet/secure_closet/ert_engi,
/turf/open/floor/mineral/titanium/tiled/yellow,
/area/shuttle/aggregeddon)
"Mi" = (
/obj/structure/table/reinforced,
/turf/open/floor/carpet/blue,
/area/shuttle/aggregeddon)
"MA" = (
/obj/structure/table/reinforced,
/obj/item/gun/energy/laser,
/obj/item/gun/energy/temperature,
/turf/open/floor/engine,
/area/shuttle/aggregeddon)
"Ns" = (
/obj/structure/chair/comfy/shuttle{
	dir = 1
	},
/turf/open/floor/carpet/stellar,
/area/shuttle/aggregeddon)
"NC" = (
/obj/machinery/door/airlock/medical/glass,
/turf/open/floor/mineral/titanium/blue,
/area/shuttle/aggregeddon)
"NK" = (
/obj/machinery/telecomms/relay/preset/auto,
/turf/open/floor/mineral/titanium/tiled/yellow,
/area/shuttle/aggregeddon)
"NQ" = (
/obj/machinery/power/emitter/welded{
	dir = 8
	},
/obj/structure/cable,
/turf/open/floor/engine,
/area/shuttle/aggregeddon)
"OU" = (
/obj/machinery/light/floor,
/turf/open/floor/mineral/plastitanium/red,
/area/shuttle/aggregeddon)
"Po" = (
/obj/machinery/light/cold/no_nightlight/directional/east,
/turf/open/floor/mineral/titanium/blue,
/area/shuttle/aggregeddon)
"Pu" = (
/obj/structure/closet/secure_closet/atmospherics,
/turf/open/floor/mineral/titanium/tiled/yellow,
/area/shuttle/aggregeddon)
"PN" = (
/obj/structure/table/reinforced,
/obj/item/gun/energy/pulse/pistol/m1911,
/obj/item/gun/grenadelauncher,
/obj/item/storage/belt/grenade/full,
/turf/open/floor/engine,
/area/shuttle/aggregeddon)
"QA" = (
/obj/machinery/modular_computer/console/preset/civilian{
	dir = 1
	},
/turf/open/floor/carpet/stellar,
/area/shuttle/aggregeddon)
"QL" = (
/obj/structure/grille,
/obj/structure/window/plasma/reinforced/plastitanium,
/turf/open/floor/engine,
/area/shuttle/aggregeddon)
"Ri" = (
/obj/machinery/airalarm/directional/east,
/obj/machinery/suit_storage_unit/ert/engineer,
/turf/open/floor/engine,
/area/shuttle/aggregeddon)
"Rj" = (
/obj/structure/table/reinforced,
/turf/open/floor/mineral/titanium/blue,
/area/shuttle/aggregeddon)
"RM" = (
/obj/machinery/airalarm/directional/east,
/obj/machinery/light/cold/no_nightlight/directional/east,
/turf/open/floor/mineral/plastitanium/red,
/area/shuttle/aggregeddon)
"RO" = (
/obj/structure/table/reinforced,
/obj/item/toy/plush/borbplushie,
/obj/structure/cable,
/obj/item/card/id/advanced/gold/captains_spare,
/obj/machinery/keycard_auth,
/turf/open/floor/carpet/stellar,
/area/shuttle/aggregeddon)
"RS" = (
/obj/machinery/light/cold/no_nightlight/directional/west,
/obj/structure/closet/crate/maint,
/turf/open/floor/circuit/red/anim,
/area/shuttle/aggregeddon)
"Sp" = (
/turf/open/floor/carpet/blue,
/area/shuttle/aggregeddon)
"Sr" = (
/obj/machinery/power/rad_collector/anchored,
/turf/open/floor/engine,
/area/shuttle/aggregeddon)
"SF" = (
/obj/structure/railing{
	dir = 8
	},
/obj/structure/chair/comfy/shuttle{
	dir = 1
	},
/turf/open/floor/carpet/executive,
/area/shuttle/aggregeddon)
"SK" = (
/obj/machinery/shieldgen,
/turf/open/floor/mineral/titanium/tiled/yellow,
/area/shuttle/aggregeddon)
"Tl" = (
/obj/machinery/door/airlock/engineering/glass,
/turf/open/floor/engine,
/area/shuttle/aggregeddon)
"Tt" = (
/obj/structure/closet/ammunitionlocker,
/turf/open/floor/engine,
/area/shuttle/aggregeddon)
"TQ" = (
/obj/structure/railing,
/obj/structure/chair/comfy/shuttle{
	dir = 4
	},
/turf/open/floor/carpet/executive,
/area/shuttle/aggregeddon)
"Ud" = (
/obj/machinery/door/airlock/engineering/glass,
/turf/open/floor/mineral/titanium/tiled/yellow,
/area/shuttle/aggregeddon)
"Us" = (
/obj/vehicle/sealed/mecha/medical/odysseus,
/turf/open/floor/mineral/titanium/blue,
/area/shuttle/aggregeddon)
"Uv" = (
/obj/machinery/stasis{
	dir = 8
	},
/obj/machinery/light/cold/no_nightlight/directional/south,
/obj/structure/curtain/bounty,
/turf/open/floor/mineral/titanium/blue,
/area/shuttle/aggregeddon)
"UM" = (
/obj/structure/chair/comfy/shuttle{
	dir = 1
	},
/turf/open/floor/circuit/red/anim,
/area/shuttle/aggregeddon)
"UN" = (
/turf/open/floor/plating/planetary/water/chlorine{
	name = "nuclear waste"
	},
/area/shuttle/aggregeddon)
"UO" = (
/obj/structure/sign/warning/explosives,
/turf/closed/wall/mineral/plastitanium,
/area/shuttle/aggregeddon)
"UW" = (
/obj/machinery/airalarm/directional/west,
/obj/structure/closet/secure_closet/engineering_chief,
/turf/open/floor/engine,
/area/shuttle/aggregeddon)
"VW" = (
/obj/structure/cable,
/turf/open/floor/engine,
/area/shuttle/aggregeddon)
"Wf" = (
/obj/machinery/airalarm/directional/north,
/obj/machinery/light/cold/no_nightlight/directional/north,
/obj/item/hand_tele,
/obj/item/hand_tele,
/obj/item/hand_tele,
/obj/structure/table/reinforced,
/turf/open/floor/carpet/stellar,
/area/shuttle/aggregeddon)
"Wh" = (
/obj/structure/bodycontainer/morgue{
	dir = 2
	},
/turf/open/floor/mineral/titanium/blue,
/area/shuttle/aggregeddon)
"Wj" = (
/turf/open/floor/mineral/plastitanium/red,
/area/shuttle/aggregeddon)
"Wr" = (
/obj/effect/spawner/lootdrop/hardsuit,
/turf/open/floor/mineral/titanium/tiled/yellow,
/area/shuttle/aggregeddon)
"Xc" = (
/obj/machinery/light/floor,
/obj/structure/closet/ammunitionlocker,
/turf/open/floor/engine,
/area/shuttle/aggregeddon)
"Xn" = (
/obj/machinery/light/floor,
/turf/open/floor/circuit/off,
/area/shuttle/aggregeddon)
"Xx" = (
/obj/structure/closet/crate/secure/gear,
/turf/open/floor/engine,
/area/shuttle/aggregeddon)
"XM" = (
/obj/machinery/light/floor,
/turf/open/floor/carpet/stellar,
/area/shuttle/aggregeddon)
"XY" = (
/obj/structure/closet/crate/secure/gear,
/turf/open/floor/circuit/red/anim,
/area/shuttle/aggregeddon)
"Yt" = (
/obj/vehicle/sealed/mecha/combat/phazon,
/turf/open/floor/engine,
/area/shuttle/aggregeddon)
"Yw" = (
/obj/machinery/light/floor,
/obj/machinery/door/poddoor/shutters{
	id = "gundoors"
	},
/turf/open/floor/engine,
/area/shuttle/aggregeddon)
"Yx" = (
/obj/vehicle/sealed/mecha/working/ripley/deathripley/real,
/turf/open/floor/engine,
/area/shuttle/aggregeddon)
"Yz" = (
/obj/machinery/recycler/deathtrap,
/turf/open/floor/iron/freezer,
/area/shuttle/aggregeddon)
"YH" = (
/obj/structure/closet/crate/medical,
/turf/open/floor/circuit/red/anim,
/area/shuttle/aggregeddon)
"Zj" = (
/turf/open/floor/mineral/titanium/blue,
/area/shuttle/aggregeddon)
"Zk" = (
/obj/machinery/shieldgen,
/turf/open/floor/mineral/titanium/blue,
/area/shuttle/aggregeddon)
"Zm" = (
/turf/open/floor/circuit/red/anim,
/area/shuttle/aggregeddon)

(1,1,1) = {"
dy
dy
dy
dA
dA
Ee
dA
dA
Ee
dy
dy
dy
dy
dy
dy
dy
dy
dy
dy
dy
dy
dy
dy
dy
dy
dA
vy
dA
vy
dy
"}
(2,1,1) = {"
dy
xO
xO
dA
dA
dA
dA
dA
dA
xO
xO
xO
dy
dy
dy
dy
dy
dy
dy
dy
dy
dy
dy
xO
xO
dA
dA
dA
dA
xO
"}
(3,1,1) = {"
xO
rR
xO
dA
dA
dA
dA
dA
dA
xO
NK
SK
xO
dy
dy
dy
dy
dy
dy
dy
dy
dy
xO
Zk
xO
dI
dI
dI
dI
xO
"}
(4,1,1) = {"
xO
hn
xO
dI
dI
dI
dI
dI
dI
xO
lA
wv
wU
QL
dy
dy
dy
dy
dy
dy
dy
QL
wU
vo
iC
wU
wU
wU
wU
xO
"}
(5,1,1) = {"
QL
hn
hn
wU
wU
wU
wU
wU
wU
wv
cJ
cJ
Wr
wU
QL
dy
dy
dy
dy
dy
QL
wU
Wh
vo
iC
ik
ik
ik
Zk
QL
"}
(6,1,1) = {"
QL
eq
Av
xO
xO
xO
xO
xO
Iz
cJ
cJ
mX
iV
cJ
wU
QL
dy
dy
dy
QL
wU
Wh
Zj
xR
Zj
Sp
Sp
Sp
Lu
QL
"}
(7,1,1) = {"
QL
xO
hn
hn
Hw
rG
ue
xO
Iz
cJ
cJ
Ce
cJ
cJ
SK
wU
QL
dy
QL
wU
Wh
Zj
Zj
Po
Zj
Sp
eu
Sp
jH
QL
"}
(8,1,1) = {"
xO
xO
no
hn
Av
hn
VW
tV
xO
uM
mZ
xO
xO
xO
xO
xO
wU
QL
wU
xO
xO
xO
xO
xO
wI
Sp
kd
Sp
Rj
xO
"}
(9,1,1) = {"
xO
lG
VW
AV
AV
AV
VW
VW
pq
GC
GC
dk
LF
LF
LF
JY
Yx
Yx
Yx
JY
Yt
Yt
Yt
dk
Zj
Sp
Mi
Sp
lp
xO
"}
(10,1,1) = {"
xO
VW
hn
wU
wU
wU
hn
uR
pq
GC
GC
dk
hn
hn
hn
hn
hn
hn
hn
hn
hn
hn
hn
dk
Zj
Sp
Mi
Sp
jH
xO
"}
(11,1,1) = {"
QL
VW
wU
UN
UN
UN
wU
hn
pq
GC
GC
dk
hn
Jz
iS
PN
hn
hn
hn
Jz
MA
cW
hn
dk
Zj
Sp
Mi
Sp
dC
QL
"}
(12,1,1) = {"
QL
mA
wU
UN
wx
UN
wU
Av
Tl
GC
Xn
dk
hn
Xc
Jz
Tt
hn
Av
hn
Tt
iS
Xc
hn
dk
Zj
Sp
Sp
Sp
Uv
QL
"}
(13,1,1) = {"
QL
VW
wU
UN
UN
UN
wU
hn
pq
GC
GC
dk
hn
AJ
MA
cW
hn
hn
hn
Jz
AJ
PN
hn
dk
Zj
Sp
Sp
Sp
dC
QL
"}
(14,1,1) = {"
xO
VW
hn
wU
wU
wU
hn
uR
pq
GC
GC
dk
hn
hn
hn
hn
hn
hn
hn
hn
hn
hn
hn
dk
Zj
Sp
eu
Sp
GY
xO
"}
(15,1,1) = {"
xO
NQ
hn
Sr
Sr
Sr
hn
hn
JP
GC
GC
dk
hn
hn
hn
hn
hn
hn
LA
hn
hn
hn
hn
dk
Zj
Sp
Sp
Sp
GY
xO
"}
(16,1,1) = {"
xO
vP
no
hn
Av
hn
xM
Ri
xO
pG
kZ
UO
QL
QL
QL
QL
kM
Tl
gO
QL
QL
QL
QL
UO
Us
Zj
Sp
Zj
HV
xO
"}
(17,1,1) = {"
QL
kx
xO
xO
xO
xO
xO
xO
Wj
OU
au
Yw
YH
RS
sp
sp
EU
qO
EU
XY
wD
cL
sp
Yw
kZ
xO
NC
xE
xO
QL
"}
(18,1,1) = {"
QL
xQ
Wj
au
Wj
Wj
au
Wj
Wj
Wj
Wj
Yw
Zm
dS
qO
oa
Zm
pw
Zm
qO
oa
qO
Zm
Yw
Gy
rB
oJ
oJ
Bf
QL
"}
(19,1,1) = {"
QL
kx
kx
kx
kx
kx
kx
kx
kx
kx
kx
oC
Ip
lv
aE
mi
Ip
mi
Ip
gu
FD
FD
Zm
Yw
oJ
oJ
oJ
oJ
oJ
QL
"}
(20,1,1) = {"
xO
kB
Wj
ds
Fl
UM
ds
Wj
UM
Wj
Wj
Yw
Zm
gu
mi
gu
Zm
Co
Zm
mi
mi
mi
Zm
Yw
oJ
oJ
oJ
mc
KL
xO
"}
(21,1,1) = {"
xO
kB
Wj
ds
Wj
UM
ds
Wj
UM
Wj
Wj
Yw
Zm
mi
aE
mi
Zm
qO
Zm
mi
mi
mi
Zm
Yw
oJ
oJ
XM
mc
QA
xO
"}
(22,1,1) = {"
xO
kB
Wj
rz
Wj
UM
rz
Fl
IQ
Wj
Wj
Yw
Zm
mi
mi
mi
Zm
Yz
Zm
mi
mi
mi
Zm
Yw
oJ
oJ
oJ
mc
KL
xO
"}
(23,1,1) = {"
QL
hl
Wj
ds
Wj
UM
ds
Wj
UM
Wj
Wj
Yw
Zm
mi
mi
mi
Zm
qO
Zm
mi
mi
mi
Zm
Yw
oJ
oJ
oJ
Zj
oJ
QL
"}
(24,1,1) = {"
QL
kt
Wj
Wj
Wj
Wj
Wj
Wj
Wj
Wj
Wj
Yw
Zm
mi
pg
mi
Zm
Co
Zm
mi
pg
mi
Zm
Yw
oJ
oJ
oJ
Zj
Bf
QL
"}
(25,1,1) = {"
QL
Wj
Wj
Wj
kB
pF
kB
kB
Wj
RM
Wj
Yw
Zm
mi
mi
mi
Zm
qO
Zm
mi
mi
mi
Zm
Yw
oJ
oJ
oJ
Zj
oJ
QL
"}
(26,1,1) = {"
gO
xO
xO
Ud
xO
xO
xO
xO
Ad
xO
kZ
xO
kH
mi
gu
mi
Zm
qO
Zm
mi
gu
mi
Zm
Yw
oJ
oJ
XM
Zj
mT
xO
"}
(27,1,1) = {"
gO
Pu
cJ
cJ
Bh
xO
iS
xH
hn
hn
hn
Yw
Zm
mi
FD
mi
Zm
qO
Zm
mi
FD
mi
Zm
Yw
oJ
oJ
oJ
mc
KL
xO
"}
(28,1,1) = {"
gO
Pu
cJ
cJ
cR
xO
iS
hn
hn
hn
hn
Yw
Zm
mi
aE
mi
Zm
Co
Zm
mi
aE
mi
Zm
Yw
oJ
oJ
oJ
mc
gn
xO
"}
(29,1,1) = {"
QL
LQ
cJ
cJ
cR
xO
Hi
hn
Av
hn
hn
Yw
Zm
mi
xg
mi
Zm
qO
Zm
mi
xg
mi
Zm
Yw
oJ
oJ
oJ
oJ
oJ
QL
"}
(30,1,1) = {"
QL
aX
cJ
mX
cJ
xO
Hi
hn
hn
hn
hn
Yw
Zm
qO
DV
qO
Zm
pw
Zm
qO
DV
qO
Zm
Yw
oJ
oJ
oJ
oJ
Bf
QL
"}
(31,1,1) = {"
QL
fB
cJ
cJ
cJ
xO
hn
hn
hn
hn
hn
Yw
Zm
Zm
DV
Zm
Zm
pw
Zm
Zm
DV
Zm
Zm
Yw
oJ
oJ
XM
oJ
oJ
QL
"}
(32,1,1) = {"
gO
fB
cJ
cJ
cJ
xO
hn
hn
hn
CO
Dl
xO
HQ
hn
DV
hn
hn
pw
hn
hn
DV
hn
HQ
xO
vW
Ns
oJ
oJ
oJ
gO
"}
(33,1,1) = {"
dy
gO
cJ
cJ
cJ
xI
hn
hn
hn
hn
gO
dy
mD
HQ
DV
hn
hn
pw
hn
hn
DV
HQ
mD
xO
Wf
oJ
qx
oJ
oJ
bl
"}
(34,1,1) = {"
dy
dy
QL
rR
hn
xO
Av
hn
rR
QL
dy
dy
dy
mD
Ah
hn
hn
pw
hn
hn
Ah
mD
dy
QL
dm
vc
oJ
oJ
oJ
gO
"}
(35,1,1) = {"
dy
dy
dy
gO
hn
xO
Xx
Xx
gO
dy
dy
dy
dy
dy
HF
HQ
hn
pw
hn
HQ
HF
dy
dy
QL
zq
oJ
oJ
oJ
oJ
gO
"}
(36,1,1) = {"
dy
dy
dy
dy
QL
gO
QL
QL
dy
dy
dy
dy
dy
dy
dy
mD
HQ
pw
HQ
mD
dy
dy
dy
QL
an
rJ
oJ
rJ
oJ
gO
"}
(37,1,1) = {"
dy
dy
dy
dy
dy
dy
dy
dy
dy
dy
dy
dy
dy
dy
dy
dy
mD
HQ
mD
dy
dy
dy
dy
gO
AL
QL
JX
QL
gO
gO
"}
(38,1,1) = {"
dy
dy
dy
dy
dy
dy
dy
dy
dy
dy
dy
dy
dy
dy
dy
dy
dy
mD
dy
dy
dy
dy
dy
ID
hn
hn
hn
hn
UW
gO
"}
(39,1,1) = {"
dy
dy
dy
dy
dy
dy
dy
dy
dy
dy
dy
dy
dy
dy
dy
dy
dy
dy
dy
dy
dy
dy
dy
ID
Av
xM
hn
xM
JZ
gO
"}
(40,1,1) = {"
dy
dy
dy
dy
dy
dy
dy
dy
dy
dy
dy
dy
dy
dy
dy
dy
dy
dy
dy
dy
dy
dy
dy
gO
gO
QL
JX
QL
gO
gO
"}
(41,1,1) = {"
dy
dy
dy
dy
dy
dy
dy
dy
dy
dy
dy
dy
dy
dy
dy
dy
dy
dy
dy
dy
dy
dy
dy
QL
iL
oJ
oJ
oJ
GO
QL
"}
(42,1,1) = {"
dy
dy
dy
dy
dy
dy
dy
dy
dy
dy
dy
dy
dy
dy
dy
dy
dy
dy
dy
dy
dy
dy
dy
QL
wt
SF
cG
bB
sI
QL
"}
(43,1,1) = {"
dy
dy
dy
dy
dy
dy
dy
dy
dy
dy
dy
dy
dy
dy
dy
dy
dy
dy
dy
dy
dy
dy
dy
QL
RO
nS
Ez
TQ
sM
QL
"}
(44,1,1) = {"
dy
dy
dy
dy
dy
dy
dy
dy
dy
dy
dy
dy
dy
dy
dy
dy
dy
dy
dy
dy
dy
dy
dy
gO
Jg
uT
gh
iT
lx
gO
"}
(45,1,1) = {"
dy
dy
dy
dy
dy
dy
dy
dy
dy
dy
dy
dy
dy
dy
dy
dy
dy
dy
dy
dy
dy
dy
dy
dy
QL
QL
QL
QL
QL
dy
"}
